###########
#-------- #
#   H     #
#         #
# -  -    #
#         #
#  -      #
#      H  #
###########