######################
#X  --#--    ---#-- X#
#---  ----  ----  -- #
#-  #------  --- #-- #
#---    -- O ---     #
#-----  ---#----  -- #
#---X-----# --  --- -#
#-------   -----  -  #
######################