###########
#     X   #
#         #
#         #
#    O    #
#         #
#         #
#         #
###########