##################
#X  --#--    ---##
#---  ----  ---- #
#-  #------  --- #
#---    -- O --- #
#---X-----# --  -#
#-------   -X--- #
##################